111111111111111111111111111111111111111111111111
10001C0000001111100000000000000111110000000C1001
10001110000011111C000000000000C11111000000111001
110000000000011111111100001111111110000000000011
111000000000000000000000000000000000000000000111
111100000000000000000000C00000000000000000001111
111110000000000000000000000000000000000000011111
100000000000000000000000000000000000000000000001
10000000000000C000000000P00000000C00000000000001
100000000000000000000000000000000000000000000001
100000001000000000000000000000000000000100000001
100000011100000000001110011100000000001110000001
100000001000000000111100001111000000000100000001
100000000000000011111100001111110000000000000001
100000000000000000111100E01111000000000000000001
100000000000000000011100001110000000000000000001
100000000011000000001100001100000000110000000001
100000000011000000001111111100000000110000000001
111110000000000000000000000000000000000000011111
11110000000C000000000000000000000000C00000001111
111000000000000000000000000000000000000000000111
11000000000000000000000C000000000000000000000011
10000000C000000000000000000000000000000C00000001
100000000000000C0000000000000000C000000000000001
111111111111111111111111111111111111111111111111
