1111111111111
1C0000P0000C1
1110000000111
1C0001E1000C1
1111111111111
